WE ./path_to_the_west_texture
SO ./path_to_the_south_texture
EA ./path_to_the_east_texture
NO ./path_to_the_north_texture

C 225,30,0
F 220,100,0


11111111111111
10000000000001
10N0111000001
11111111000001                 111111
       1000001                10000001
       10000001            111000000001
       100000001           1100000000001
       1000000001          10000000000001
       10000000001111111111000000000000001
       10000010000000000000000000011000001
       100010000011111111110000001  1000001
       1000010001          100000011000001
       100000101           11000000000001
       10000001        E     10000000001
       1111111                100000001
                               1111111