NO ./textures/north_texture.xpm
SO ./textures/south_texture.xpm
WE ./textures/west_texture.xpm
EA ./textures/east_texture.xpm

F 220,100,0
C 225,30,0

  111
 11111
1111111
111E111
1111111
 11111
  111
