

NO     ./path_to_the_north_texture


C    66,184,252
SO       ./path_to_the_south_texture



WE               ./path_to_the_west_texture
F    69,46,1


EA          ./path_to_the_east_texture


                11111111          111111111111111111
                10000001          100000000000000001
             11110000001       111100000000000000001
            10000001111       1000000111111110000001
         11110000001111       10000001   11110000001
        1000000110000001       111111   10000001111
     1111000000110000001           1111110000001
    1000000111100000011           1000000001111
 11110000001  10000001111111111111100000011
10000000001111000000000000000000000001111
1000000000000000000000000000000000011
 1111111111000000111111110000001111
         110000001   1111000000111111111111
        10000N011   100000000000000000000001
        10000001    100000000000000000000001
        11111111    111111111111111111111111
