

NO     ./textures/north_texture.xpm


C    66,184,252
SO       ./textures/south_texture.xpm



WE               ./textures/west_texture.xpm
F    69,46,1


EA          ./textures/east_texture.xpm


                11111111          111111111111111111
                10000001         1100000000000000001
             11110000001       110000000000000000001
            100000000011      1000000011110000000001
         111100000000011      10000001   11000000001
        1000000010000001       111111   10000001111
     1111000000110000001           1111100000001
    1000000111100000001           1000000001111
 11110000001  10000001111111111111100000011
10000000001111000000000000000000000001111
1000000000000000000000000000000000011
 1111111111000000111111110000000111
         110000001   1110000000111111111111
        10000N011   100000000000000000000001
        10000001    100000000000000000000001
        11111111    111111111111111111111111
